11111111111112
10000000000012
10110110101012
10110110101012
100000030101012
10111111101012
10000000000012
11111111111112