111111111111112
100000000000012
1001113030111303012
100111001110012
100000000000012
111111111111112