111111111111111111111111111111111112
100000000000000000000000000000000012
101111111011111110111111101111111012
101111111011111110111111101111111012
1p1111111011111110111111101111111012
101111111011111110111111101111111012
101111111011111110111111101111111012
101111111011111110111111101111111012
101111110001111100011111000111111012
100000000000000000000000000000000012
101111110001111100011111000111111012
101111111011111110111111101111111012
101111111011111110111111101111111012
10111111101113000000003011101111111012
101111111011100000000011101111111012
101111111011100000000011101111111012
101111110001100000000011000111111012
100000000000000000000000000000000012
101111110001100000000011000111111012
101111111011100000000011101111111012
101111111011100000000011101111111012
10111111101113000000003011101111111012
101111111011111110111111101111111012
101111111011111110111111101111111012
101111110001111100011111000111111012
100000000000000000000000000000000012
101111110001111100011111000111111012
101111111011111110111111101111111012
101111111011111110111111101111111012
101111111011111110111111101111111012
101111111011111110111111101111111012
101111111011111110111111101111111012
101111111011111110111111101111111012
100000000000000000000000000000000012
111111111111111111111111111111111112