11111111111111111112
1004000000000000004012
10110100000001011012
10100100000001001012
10100100000001001012
10101100000001101012
10000000000000000012
101011011301101101012
10100101000101001012
1010010300003000001012
10100101000101001012
101101011301101011012
10000000000000000012
10110100000001011012
10100100000001001012
10100100000001001012
10101100000001101012
1400000000000000040012
11111111111111111112