1111111111111112
1000000000000012
1010101010101012
1010101010101012
10000003000000012
1010101010101012
1010101010101012
1000000000000012
1111111111111112