111111111111111112
100010001000100012
100000000000000012
100010400104001040012
100010001000100012
11111v1v1v1v1v1v12
11111vvv1vvv1vvv12
111111111111111112